5.ox
...o....
........
......o.
........
........
